45,26
1-------------------------------------------1
1-------------------------------------------1
1-------------------------------------------1
1-------------------------------------------1
1----zz------------------------------zz-----1
1-------------------------------------------1
1-----------------z-------------------------1
1-------------------------------------------1
1-------------------------------------------1
1--------------------------R----------------1
1------------------------zzzz---------------1
1-------------------------------------------1
1------R------------------------------------1
1-----zzz------------------------------z----1
1-------------------------------------------1
1-------------------------------------------1
1-------------------zzzzz-------------------1
1-------------------------------------------1
1-------------------------------------------1
1------------z----------------z-------------1
1-------------------------------------------1
1-RS------------------------------------SR--1
1zzzz-----------------------------------zzzz1
1-------------------------------------------1
1-------------------------------------------1
1-------------------------------------------1