45,26
1-------------------------------------------1
1-------------------------------------------1
1-------------------------------------------1
1-------------------------------------------1
1-------------------------------------------1
1--R-------------------------------------R--1
1zzzzzz-------------------------------zzzzzz1
1-------------------------------------------1
1--------------------R----------------------1
1-----------------zzzzzzzzz-----------------1
1-------------------------------------------1
1-------------------------------------------1
1-------------------------------------------1
1--zzzzz-----------------------------zzzzz--1
1-------------------------------------------1
1---------------------R---------------------1
1---------------zzzzzzzzzzzzz---------------1
1----S---------------------------------S----1
1-------------------------------------------1
1-------------------------------------------1
1zzzzzzzzz-------------------------zzzzzzzzz1
1-------------------------------------------1
1-------------------------------------------1
1-------------------------------------------1
1-------------------------------------------1
1-------------------------------------------1