45,26
1zzzzzzzzzzzzzzzzzzzzzzzzzzzzzzzzzzzzzzzzzzz1
1-------------------------------------------1
1----R---------------------------------R----1
1zzzzzzzzzz----------------------zzzzzzzzzzz1
1-------------------------------------------1
1-------------------------------------------1
1---------------zzz-------zzz---------------1
1-------------------------------------------1
1--R-------------------------------------R--1
1zzzzzz-------------------------------zzzzzz1
1-------------------------------------------1
1--------------------R----------------------1
1-----------------zzzzzzzzz-----------------1
1-------------------------------------------1
1-------------------------------------------1
1-------------------------------------------1
1--------zzzz-------------------zzz---------1
1---------------------R---------------------1
1-----------------zzzzzzzzz-----------------1
1----S---------------------------------S----1
1zzzzzzzzzz-----------------------zzzzzzzzzz1
1-------------------------------------------1
1-------------------------------------------1
1-------------------------------------------1
1-------------------------------------------1
1MMMMMMMMMMMMMMMMMMMMMMMMMMMMMMMMMMMMMMMMMMM1